A Man Without Love LYRICS Video Engelbert Humperdinck 1968 Moon Knight.mp3
AJR - World's Smallest Violin (Official Video).mp3
Alan Walker & Ava Max - Alone, Pt. II.mp3
Alan Walker, Sabrina Carpenter & Farruko  - On My Way.mp3
Alec Benjamin - Let Me Down Slowly [Official Music Video].mp3
American Authors - Best Day Of My Life.mp3
Ashe - Moral of the Story (Official Audio).mp3
Attack on Titan 2 - 'Barricades' with Lyrics.mp3
AURORA - Runaway.mp3
Barricades.mp3
Blackway & Black Caviar - -What's Up Danger- (Spider-Man- Into the Spider-Verse).mp3
Blue Bird- - ikimono - gakari (LYRIC) OP 3 Naruto Shippuden.mp3
BoyWithUke - Toxic (Official Lyric Video).mp3
Buttercup - Animation.mp3
Calvin Harris, Dua Lipa - One Kiss (Lyrics).mp3
Chopstick Brothers -- Little Apple - (lyrics, pinyin).mp3
CHROMANCE - Wrap Me In Plastic (Lyrics).mp3
Coldplay - Hymn For The Weekend (Official Video).mp3
Dancin - Anime Mix [500K].mp3
Divine Resonance- Lord Vishnu Stotram in Mesmerizing Anime-.mp3
Dua Lipa - Levitating Featuring DaBaby (Official Music Video).mp3
Eminem - Mockingbird [Official Music Video].mp3
Fall Out Boy - Immortals (from Big Hero 6).mp3
FRANK SINATRA - Can't Take My Eyes Off You (Lyrics) -I love you baby and if it's quite all right-.mp3
Ghungroo Song - WAR - Hrithik Roshan, Vaani Kapoor - Arijit Singh, Shilpa - Vishal & Shekhar, Kumaar.mp3
Glass Animals - Heat Waves (Official Video).mp3
Gotye - Somebody That I Used To Know (feat. Kimbra) [Official Music Video].mp3
Gotye performing -Somebody That I Used To Know- Live on KCRW.mp3
Hanuman Chalisa Super Fast - Hanuman Chalisa.mp3
ilyaugust - Chosen  Dreaming, Dreaming of This Moment  (Official Lyric Video).mp3
Imagine Dragons & JID - Enemy (from the series Arcane- League of Legends) - Official Music Video.mp3
Imagine Dragons - Believer (Official Music Video).mp3
Imagine Dragons - Bones (Official Music Video).mp3
Jennifer Lopez - On The Floor ft. Pitbull.mp3
Jim Croce - Time In A Bottle.mp3
Kate Bush - Running Up That Hill - Official Music Video.mp3
Kimi no toriko Summertime - Maggie - Lyrics Video.mp3
kyOresu - Lalala by bbno & y2k (loli cover).mp3
La Casa De Papel - Bella Ciao [Lyrics] (Money Heist).mp3
La casa de papel Soundtrack - Cecilia Krull - My life is going on (Lyric Video).mp3
Legends Never Die (ft. Against The Current) - Worlds 2017 - League of Legends.mp3
Lenka - Everything At Once.mp3
Leonard Cohen - Hallelujah (Audio).mp3
Lily- Alan Walker-  Animatic.mp3
Makudonarudo Namawee - Tokyo Bon 2020.mp3
Man or a monster - animatic2.mp3
Marnik & KSHMR - Alone (feat. Anjulie & Jeffrey Jey) [Official Lyric Video].mp3
Marnik - Up & Down (Official Video).mp3
Maroon 5 - Memories (Official Video).mp3
Marshmello - Alone (Official Music Video).mp3
Masked Wolf - Astronaut In The Ocean (Official Music Video).mp3
Mere Mitwa Mere Meet Re - Lata Mangeshkar, Mohammed Rafi - Geet Songs - Rajendra Kumar, Mala Sinha.mp3
Mitwa Full Video - KANK-Shahrukh Khan,Rani Mukherjee-Shafqat Amanat Ali-Shankar Mahadevan.mp3
MV - Jack Stauber - Buttercup.mp3
Namo Namo - Lyrical - Kedarnath - Sushant Rajput - Sara Ali Khan - Amit Trivedi - Amitabh B.mp3
Nirvana - Something In The Way (Audio).mp3
One Direction - Night Changes.mp3
Owl City & Carly Rae Jepsen - Good Time (Official Video).mp3
Phao - 2 Phut Hon (KAIZ Remix) - 9D AUDIO.mp3
Phao - 2 Phut Hon (KAIZ Remix) - TikTok Vietnamese Music 2020.mp3
Post Malone, Swae Lee - Sunflower (Spider-Man- Into the Spider-Verse).mp3
Powfu - death bed (coffee for your head) (Official Video) ft. beabadoobee.mp3
Princess Chelsea - The Cigarette Duet.mp3
PUBLIC - Make You Mine (Put Your Hand in Mine) [Official Video].mp3
Ritviz - Liggi [Official Music Video].mp3
Shape of You  [ AMV - MIX ] Anime Mix.mp3
Shiv Tandav Stotram 16D Audio - Use Headphones.mp3
Sia - Cheap Thrills (Lyrics) ft. Sean Paul.mp3
Sia - Cheap Thrills Ft. Sean Paul (Espa ol + Lyrics).mp3
Stephen Sanchez - Until I Found You.mp3
Superhero.mp3
SUZUME ost AMV - Lyrics.mp3
Teri Yaadon Mein (Full Song) - The Killer.mp3
The Weeknd - Blinding Lights (Official Video).mp3
Tom Odell - Another Love (Official Video).mp3
TONES AND I - DANCE MONKEY (OFFICIAL VIDEO).mp3
Tu Tu Hai Wahi (( 4K Video )) - Yeh Vaada Raha - Rishi Kapoor, Poonam D - Asha Bhosle, Kishore Kumar (2).mp3
Tum Prem Ho - Reprise - Lyrical Video - Radha Krishn - MOhit Lalwani - Surya Raj Kamal.mp3
Tum Prem Ho {Slowed Reverb} 2023 -(janmashtami special) -- Music Hub M.mp3
Y2K bbno - Lalala (Official Video).mp3
